+-------------------------------------------------------------------------+
|*********************************/\\*************************************|
|********************************//#\\************************************|
|********************************/###\\***********************************|
|*****************************//######\\**********************************|
|****************************//#########\\********************************|
|****/\**********************/###########\\****************************/\*|
|*////\\*******************///############\\**************************//\\|
|*////##\\****************//###############\\***********************////\\|
|///######\*************//###################\\*******************//////\\|
|//########\\*********///#####################\\\**************///////##\\|
|/##########\\\******//#########################\\\***********//////#####\|
|#############\\****//##########+----+############\\*********//////####/\\|
|####/\\#######\\**//###########+vvvv+\############\\*****/////######///\\|
|###//#\\\######\\/###########//......\\############\\**////########///#\\|
|##/#####\\#######\##########//........\\############\/////#######///####\|
|#//######\\######\\########//..........\\###########/////######///#######|
|//########\\######\#######//............\\########//////#####///#######//|
|/##########\\######\\#####/..............\\######//////#####//#######///#|
|#############\######\####/................\#####////#######//#######//###|
+-------------------------------------------------------------------------+